2111111111112
1101000000C11
1000011111001
11P011E000011
2111111111112