 11111111111 
1101000000C11
1000011111001
11P011E000011
 11111111111 